social attitudes	conductas sociales
harm	agravio, daño	agravio está más enfocado a un ámbito legal
advocacy	defensa y promoción, incidencia, defensa, lucha
outcomes	resultados
arenas	ámbitos
accountability	responsabilidad, rendición de cuentas	puede matizarse 'social', 'pública'
outcomes	resultados, desenlaces
awareness	conciencia	despertar conciencia 
court	tribunal
at national, regional and global levels	a escala regional, nacional e internacional
treaty bodies	tratados, convenios
rapporteurs	relatoras, relatores
overarching	globales, de peso, centrales
To bring about	contribuir, provocar, facilitar
foundation	cimiento
far reaching	trascendental, de amplio alcance
eliciting	provocar, suscitar, obtener
put into place	establecer, poner en vigor, poner en práctica, poner en su lugar
in the aftermath 	a raíz de, fruto de, después
redress	reparación, compensación, resarcimiento, indemnización	redress
repackaged	reformulado, adaptado
grounding in	fundamentar en
shadow report	informe paralelo
having a paper trail	poner sobre papel
lobbying	cabildeo, persuasión política
simply	meramente, simplemente, sencillamente
range of	abanico, surtido, diversidad
timely way	de manera oportuna, a tiempo
underpin	sustentar
feasible	factible
Unlawful	ilícito
Drop In Centr	centro social
rallying	movilizadora, alentadora, 	rallying
rampant	generalizar, extender, avanza
dragnet	red de arrastre
dismay	consternación
groundbreaking	innovadores
chair	presidenta
government officials	autoridades del gobierno
government bodies	organismos del gobierno
appeals	solicitudes
nuance	matizar
